 ___________________________________________________________________________________________________ 
|                                                                                                   |
|                                                                                                   |
|                                                                                                   |
|___________________________________________________________________________________________________|
|                                                                                                   |
|                                                                                                   |
|                                                                                                   |
|                                                                                                   |
|= = = = = = = = = = = = = = = = = = = = = = = = = = = = = = = = = = = = = = = = = = = = = = = = = =|
|                                                                                                   |
|                                                                                                   |
|                                                                                                   |
|___________________________________________________________________________________________________|
|                                                                                                   |
|                                                                                                   |
|                                                                                                   |
|                                                                                                   |
|                                                                                                   |
|                                                                                                   |
|___________________________________________________________________________________________________|
|                                                                                                   |
|                                                                                                   |
|                                                                                                   |
|                                                                                                   |
|= = = = = = = = = = = = = = = = = = = = = = = = = = = = = = = = = = = = = = = = = = = = = = = = = =|
|                                                                                                   |
|                                                                                                   |
|                                                                                                   |
|___________________________________________________________________________________________________|
|                                                                                                   |
|                                                                                                   |
|                                                                                                   |
|                                                                                                   |
|                                                                                                   |
|                                                                                                   |
|___________________________________________________________________________________________________|
|                                                                                                   |
|                                                                                                   |
|                                                                                                   |
|___________________________________________________________________________________________________|